alias z="zypper"
alias zlr="zypper lr"
alias zref="zypper ref"
alias zar="zypper ar"
alias zs="zypper search"
alias zif="zypper if"
alias zin="zypper in"
alias zrm="zypper rm"
alias zdr="zypper mr -d"
alias zer="zypper mr -e"
alias zif2="rpm -ql"

alias osg="openstack security group"
alias osgl="openstack security group list"
alias osgs="openstack security group show"
alias osgd="openstack security group delete"
alias os="openstack server"
alias osl="openstack server list"
alias oss="openstack server show"
alias osd="openstack server delete"
alias op="openstack project"
alias opl="openstack project list"
alias olb="openstack loadbalancer"
alias olbl="openstack loadbalancer list"
alias olbs="openstack loadbalancer show"
alias olbd="openstack loadbalancer delete"
alias ofl="openstack flavor list"
alias ofs="openstack flavor show"
alias oil="openstack image list"
alias ois="openstack image show"
alias oid="openstack image delete"
alias on="openstack network"
alias onl="openstack network list"
alias ons="openstack network show"

alias clogc="tail -f /var/log/crowbar/production.log"
alias clog="less /var/log/crowbar/production.log"
alias cstop="systemctl stop crowbar"
alias crestart="systemctl restart crowbar"
alias cstatus="systemctl status crowbar"
alias cmanual="/usr/bin/puma -C /opt/dell/crowbar_framework/config/puma.rb"
alias crestartfull="pushd . && cd /opt/dell/crowbar_framework && export RAILS_ENV=\"production\" && rake crowbar:schema_migrate && rake crowbar:schema_migrate_status && service crowbar restart && popd"

alias sstatus="systemctl status"
alias sstop="systemctl stop"
alias srestart="systemctl restart"

alias kcu="knife cookbook upload"
